30
30
000000000000000000000000000000
000000000000000000000000000000
001111111111111111111111111100
001111444444111111111111111100
001114444444441111111111111100
001114444444441111111111111100
001144441111111111111111111100
001144441111111111111111111100
001144441111111111111111111100
001144441111116111111111111100
001144441111111111111111111100
001111111111111111111111111100
001111111111111111111111111100
001111111111111111111111111100
001111111111111111111111111100
001111111111111111111111111100
001111111111111111111111111100
001111111111111111111111111100
001111111111111111111111111100
001111111111111111111111111100
001111111111111111111111111100
001111111111111111111111111100
001111111111111111111111111100
001111111111111111111111111100
001111111111111111111111111100
001111111111111111111111111100
001111111111111111111111111100
001111111111111111111111111100
000000000000000000000000000000
000000000000000000000000000000