20
20
00000000000000000000
00000000000000000000
00110001101100000000
00110011101110001100
00000111100111001100
00001110000111001100
00111100000000000000
00111000000000110000
00011000000000110000
00000011100000110000
00000011102011111100
00011011000011111100
00011100000000110000
00001111001110110000
00000111001110110000
00001111001111000000
00001110000111000000
00001110000111000000
00000000000000000000
00000000000000000000