20
20
00000000000000000000
00000000000000000000
00110001101100000000
00110011101110001100
00000111100111001100
00001110000111001100
00333000222000000000
00333000222000110000
00333000222000110000
00000011100000110000
00000011100011111100
00011011000011111100
00011100040000110000
00001111001110110000
00000111001110110000
00001111001111000000
00001110000111000000
00001110000111000000
00000000000000000000
00000000000000000000