20
20
00000000000000000000
00000000000000000000
00011001101100000000
00011011101110001100
00000111100111001100
00000110000111001100
00111000000000000000
00111000000000110000
00011000000000110000
00000011100000110000
00110011102011111100
00111011000011111100
00111000000000110000
00000111001110110000
00000111001110110000
00001111001111000000
00001110000111000000
00001110000111000000
00000000000000000000
00000000000000000000