20
10
11111111111111111111
11111111111111111111
11100000000000000111
11000000000000000011
11000000112000110011
11000000110011110011
11000000000011100011
11100000000000000111
11111111111111111111
11111111111111111111
