20
10
11111111111111111111
10000000010000000001
10000000010001111111
10111000010001000001
10000000000000000001
10000000010100000001
10001110010100000001
10000010010111110001
10000000010000000001
11111111111111111111