20
20
00000000000000000000
00111111110000000000
00111144411100000000
00111144411110001100
00111111111111001100
00000110000111001100
00333000222000000000
00333000222000110000
00333000222000110000
00000011100000110000
00000011100011111100
00011011060011111100
00011100000000110000
00001111001110110000
00000111001110110000
00001111001111000000
00001110000111000000
00001110000111000000
00000000000000000000
00000000000000000000