30
30
000000000000000000000000000000
001111111100000000000000000000
001111444111000000000000000000
001111444111100011000000000000
001111111111110011000000000000
000001100001110011000000000000
003330002220000000000000000000
003330002220001100000000000000
003330002220001100000000000000
000000111000001100000000000000
000000111000111111000000000000
000110110000111111000000000000
000111000660001100000000000000
000011116611101100000000000000
000001110011101100000000000000
000011110011110000000000000000
000011100001110000000000000000
000011100001110000000000000000
000000000000000000000000000000
000000000000000000000000000000
000000000000000000000000000000
000000000000000000000000000000
000000000000000000000000000000
000000000000000000000000000000
000000000000000000000000000000
000000000000000000000000000000
000000000000000000000000000000
000000000000000000000000000000
000000000000000000000000000000
000000000000000000000000000000