20
20
11111111111111111111
11111111111111111111
11011001101100000111
11011011101110001111
11000111100111001111
11000110000111001111
11111000000000000011
11111000000000110011
11011000000000110011
11000011100000110011
11110011102011111111
11111011000011111111
11111000000000110011
11000111001110110011
11000111001110110011
11001111001111000011
11001110000111000011
11001110000111000011
11111111111111111111
11111111111111111111